1111011111
1111000001
1000110111
1010000111
1011111111